+--+--+--+--+--+--+--+--+--+--+--+--+--+--+--+
            |              |        |     |  |
+--+  +--+  +--+  +--+--+  +  +--+--+  +  +  +
|  |  |  |              |              |     |
+  +  +  +--+--+  +  +--+--+  +--+--+--+--+--+
|     |           |     |     |              |
+  +--+--+  +--+--+--+  +  +--+  +  +--+--+  +
|        |     |     |  |  |     |        |  |
+--+--+  +  +  +--+  +  +  +  +--+--+--+--+  +
|     |     |  |           |  |  |           |
+--+  +--+--+  +  +  +  +  +  +  +  +  +--+--+
|     |     |     |  |     |  |  |  |  |     |
+  +--+  +--+  +--+  +  +--+  +  +  +  +  +  +
|  |           |        |     |     |     |  |
+  +--+--+--+--+  +  +  +  +--+--+--+--+--+  +
|  |              |  |     |     |     |     |
+  +  +--+--+--+--+--+  +--+--+  +  +  +  +--+
|  |  |        |     |     |     |  |     |  |
+  +  +  +--+  +  +  +--+--+  +--+  +--+--+  +
|     |  |     |  |           |  |     |     |
+  +--+  +--+--+  +--+--+  +--+  +--+  +  +  +
|     |           |           |        |  |  |
+  +--+--+--+  +--+  +--+--+  +  +--+--+  +--+
|     |              |              |        |
+--+  +--+--+  +--+--+  +--+--+--+  +--+  +  +
|     |     |  |                 |        |  |
+  +--+  +  +  +--+--+--+--+--+  +--+--+--+  +
|     |  |              |     |     |     |  |
+--+  +--+--+  +--+--+  +  +--+--+  +  +--+  +
|                       |           |         
+--+--+--+--+--+--+--+--+--+--+--+--+--+--+--+