+--+--+--+--+--+--+--+--+--+--+--+--+--+--+--+
            |              |        |     |  |
+--+  +--+  +--+--+--+--+  +  +--+--+  +  +  +
|  |  |  |        |     |              |     |
+  +  +  +--+--+  +  +--+--+  +--+--+--+--+--+
|     |           |     |     |              |
+  +--+--+--+--+--+--+  +  +--+  +  +--+--+  +
|        |     |     |  |  |     |        |  |
+--+--+  +  +  +--+  +  +  +  +--+--+--+--+  +
|     |     |  |        |  |  |  |           |
+--+  +--+--+  +  +  +  +  +  +  +  +  +--+--+
|     |     |     |  |     |  |  |  |  |     |
+  +--+  +--+  +--+  +  +--+  +  +  +  +  +  +
|  |           |     |  |     |     |     |  |
+  +--+--+--+--+  +  +  +  +--+--+--+--+--+  +
|  |              |  |     |     |     |     |
+  +  +--+--+--+--+--+  +--+--+  +  +  +  +--+
|  |  |        |     |     |     |  |     |  |
+  +  +  +--+  +  +  +--+--+  +--+  +--+--+  +
|     |  |     |  |           |  |     |     |
+  +--+  +--+--+  +--+--+--+--+  +--+  +  +  +
|     |           |           |        |  |  |
+  +--+--+--+  +--+  +--+--+  +--+--+--+  +--+
|     |              |              |        |
+--+  +--+--+  +--+--+  +--+--+--+  +--+  +  +
|     |     |  |                 |        |  |
+  +--+  +  +  +--+--+--+--+--+  +--+--+--+  +
|     |  |              |     |     |     |  |
+--+  +--+--+  +--+--+  +  +--+--+  +  +--+  +
|              |        |           |         
+--+--+--+--+--+--+--+--+--+--+--+--+--+--+--+