+--+--+--+--+--+--+--+--+--+--+--+--+--+--+--+--+--+--+--+--+
            |     |        |                 |     |     |  |
+--+--+--+  +  +  +  +--+  +  +--+--+  +--+  +  +  +  +  +  +
|  |           |  |  |  |  |  |  |        |     |     |     |
+  +  +--+--+  +  +  +  +  +  +  +  +--+--+--+--+--+  +--+--+
|  |  |  |     |  |     |  |  |     |        |        |     |
+  +  +  +  +--+  +--+--+  +  +--+--+  +--+  +  +--+  +  +  +
|     |     |     |        |     |  |  |  |     |     |  |  |
+  +--+--+--+  +--+  +--+  +--+  +  +  +  +--+--+  +--+  +  +
|  |     |  |     |  |  |  |  |        |           |     |  |
+  +  +  +  +  +--+  +  +  +  +  +--+  +--+--+  +--+  +--+  +
|     |  |           |     |     |        |     |  |     |  |
+  +--+  +  +  +--+  +--+--+--+--+  +--+  +  +--+  +--+--+  +
|     |     |           |        |     |  |     |           |
+  +--+  +--+--+--+--+  +  +--+  +--+--+  +--+  +  +--+--+--+
|                 |     |     |        |  |     |           |
+  +  +--+--+--+  +  +--+--+  +--+--+  +  +  +--+--+--+--+  +
|  |  |  |  |     |  |     |  |     |  |  |              |  |
+  +  +  +  +  +--+--+--+  +  +  +  +  +  +--+--+--+--+  +--+
|  |     |  |           |     |  |     |              |  |  |
+  +--+  +  +  +--+--+--+--+--+  +--+--+  +  +--+  +  +  +  +
|     |              |           |     |  |        |  |     |
+--+  +--+--+  +--+  +  +--+  +--+  +  +--+  +--+--+--+--+  +
|     |        |  |  |  |     |     |     |        |        |
+  +--+  +--+  +  +  +  +  +--+  +--+  +  +--+--+  +  +--+--+
|  |     |     |     |  |  |     |     |           |        |
+  +  +--+  +--+  +--+  +  +  +--+  +--+--+  +--+--+--+  +  +
|     |     |  |        |     |           |        |  |  |  |
+--+  +  +--+  +--+--+--+  +  +  +  +--+  +--+  +  +  +  +  +
|     |  |        |        |     |     |     |  |  |     |  |
+  +--+  +  +--+  +  +  +  +  +--+--+  +--+  +--+  +--+--+  +
|     |     |  |     |  |              |  |  |     |        |
+  +  +--+--+  +--+--+--+--+--+  +  +--+  +  +  +  +--+--+--+
|  |  |     |           |        |  |     |     |  |        |
+  +  +  +  +--+--+--+  +  +--+--+  +  +--+  +  +--+--+  +  +
|  |     |           |  |  |     |  |        |           |  |
+  +--+--+--+--+--+  +  +  +--+  +  +--+--+  +--+--+--+--+  +
|  |  |              |  |  |     |     |                    |
+  +  +  +--+--+--+--+  +  +  +--+  +  +  +--+--+  +  +--+--+
|     |                 |     |     |     |        |         
+--+--+--+--+--+--+--+--+--+--+--+--+--+--+--+--+--+--+--+--+