+--+--+--+--+--+--+--+--+--+--+
   |     |        |        |  |
+  +  +  +--+  +  +  +--+  +  +
|     |  |     |  |  |     |  |
+--+--+  +  +--+  +  +  +--+  +
|  |        |        |     |  |
+  +  +--+--+  +--+--+  +--+  +
|  |  |     |     |           |
+  +  +  +--+--+  +--+--+--+--+
|     |  |                    |
+--+--+  +  +--+  +--+--+--+  +
|     |     |     |  |        |
+--+  +--+--+--+--+  +  +  +--+
|              |     |  |     |
+  +--+--+--+  +  +  +  +  +--+
|  |        |     |     |     |
+  +--+  +  +--+--+--+--+--+  +
|  |     |  |        |        |
+  +  +--+  +--+--+  +  +  +--+
|     |              |  |      
+--+--+--+--+--+--+--+--+--+--+