+--+--+--+--+--+--+--+--+--+--+--+--+--+--+--+--+--+--+--+--+
            |     |        |                 |     |     |  |
+--+--+--+  +  +  +  +--+  +  +--+--+  +--+  +  +  +  +  +  +
|  |        |  |  |  |  |  |  |  |        |     |     |     |
+  +  +--+--+  +  +  +  +  +  +  +  +--+--+--+--+--+--+--+--+
|  |  |  |     |  |     |  |  |     |        |        |     |
+  +  +  +  +--+  +--+--+  +  +--+--+  +--+  +  +--+  +  +  +
|     |     |     |        |     |  |  |  |     |     |  |  |
+  +--+--+--+  +--+  +--+  +--+  +  +  +  +--+--+  +--+  +  +
|  |     |  |     |  |  |  |  |        |           |     |  |
+  +  +  +  +  +--+  +  +  +  +  +--+  +--+--+  +--+  +--+  +
|     |  |           |     |     |        |     |  |     |  |
+--+--+  +  +  +--+--+--+--+--+--+  +--+  +  +--+  +--+--+  +
|     |     |           |        |     |  |     |           |
+  +--+--+--+--+--+--+  +  +--+  +--+--+  +--+  +  +--+--+--+
|                 |     |     |        |  |     |           |
+--+  +--+--+--+  +  +--+--+  +--+--+  +  +  +--+--+--+--+  +
|  |  |     |     |        |  |     |  |  |              |  |
+  +  +  +  +  +--+--+--+  +  +  +  +  +  +--+--+--+--+  +  +
|  |     |  |           |     |  |     |              |  |  |
+  +--+  +  +--+--+--+--+--+--+  +--+--+  +--+--+  +  +  +  +
|        |           |           |     |  |        |  |     |
+--+--+--+--+--+--+  +  +--+  +--+  +  +--+  +--+--+--+--+  +
|     |        |  |  |  |     |     |     |        |        |
+  +--+  +--+  +  +  +  +  +--+  +--+  +  +--+--+  +  +--+--+
|  |     |     |     |  |  |     |     |           |        |
+  +  +--+  +--+  +--+  +  +  +--+  +--+--+  +--+--+--+  +  +
|     |     |  |        |     |           |  |     |  |  |  |
+--+  +  +--+  +--+--+--+--+--+  +  +--+  +--+  +  +  +  +  +
|     |  |        |        |     |     |     |  |  |     |  |
+  +--+  +  +--+  +  +  +  +  +--+--+  +--+  +--+  +--+--+  +
|     |     |  |     |  |     |        |  |  |     |        |
+  +  +--+--+  +--+--+--+--+--+  +  +--+  +  +  +  +  +--+--+
|  |  |     |           |        |  |     |     |  |        |
+  +  +  +  +--+--+--+  +  +--+--+  +  +--+  +--+--+--+  +  +
|  |     |           |  |  |     |  |        |           |  |
+  +--+--+--+--+--+  +  +  +--+  +  +--+--+--+--+--+--+--+  +
|  |  |              |  |  |     |     |           |        |
+  +  +  +--+--+--+--+  +  +  +--+  +  +  +--+--+  +  +--+--+
|     |                 |     |     |     |        |         
+--+--+--+--+--+--+--+--+--+--+--+--+--+--+--+--+--+--+--+--+