+--+--+--+--+--+--+--+--+--+--+
   |     |        |        |  |
+  +  +  +--+  +  +  +--+  +  +
|     |  |     |  |  |     |  |
+  +--+  +  +--+  +  +  +--+  +
|  |        |        |     |  |
+  +  +--+--+  +--+--+  +--+  +
|  |  |     |     |           |
+  +  +  +--+--+  +--+--+  +--+
|     |  |                    |
+--+  +  +  +--+  +--+--+--+  +
|     |     |     |  |        |
+--+  +  +--+--+--+  +  +  +--+
|              |     |  |     |
+  +--+--+--+  +  +  +  +  +--+
|  |        |     |     |     |
+  +--+  +  +--+  +--+--+--+  +
|  |     |  |        |        |
+  +  +--+  +--+--+  +  +  +--+
|                    |  |      
+--+--+--+--+--+--+--+--+--+--+