+--+--+--+
      |  |
+--+  +  +
|     |  |
+  +--+  +
|         
+--+--+--+